###########################################
#    #   # #  #   #   #     ##   # ##  # ##
#  #   ! #!      #            # ##  #   ###
#   !#       #      #           !   #     #
#      #    A# # !     ##  !   ##  !    # #
#        # ##   ##  ######     #  # #A    #
#  #    # # # #  !!       #          #    #
##            #    #    #   ! # #         #
#        #           #    #     A         #
#    !  #    #        #  # !!#     #     ##
##    #    # #   #      #            #    #
#  ##!  #    #      ##     #  ##  # #   # #
# !##  #!#         AAA     A  ##        # #
#     # #      #  #!   #   !       #  !   #
##  !###       #         !   #!    ##   # #
##  !  ## !  # !     ###   #  A #!     ## #
##  ##   #         #   #     #  #    # ## #
#  #     #    #   #   # #  #     ###  !#  #
#        #   !#               #  A     ## #
#  ##   !      #      # ##       #   #    #
#    # # # #     ! !       #  # ##!       #
#!#    #        !         A#  #   #!#     #
###########################################