###########################################
## # ##!     #     #     # #           ## #
#                             ## #        #
#     #             ###     ##      ####  #
#A !    #   A#  # # ##      #   #   #  # ##
# # #        ##   !    #   #     #    #   #
#       ##       #       ### #       ##   #
#       #           !   ## #  ##      ##  #
#    # #   #          #   #   #   #     ! #
# #   #    #             #    #        ## #
#    #     ##        #       ###          #
###   # #     ##             #           ##
###       #  ##       ##     ##        #  #
#     # ##   ##    ! # #                  #
#   ##     #     #   A#      ##     #  #  #
#        ##       A    #   ##          # ##
##  #   ##     ##       #           ##    #
#  #    #  #    #      # !   #       #  # #
#  ####   ## #         # #         #AA    #
##          # ##     #       #   !  # #   #
#                # #  #   A   #  #   # ## #
#!     #    ! #    # #      #  # #       ##
###########################################